Inglourious Basterds - 2009 - Tarantino

once upon a time - однажды
go back inside - зайдите внутри
and shut the door - и закройте дверь
for wash up - чтобы умыться
is this a property of LaPadite - это частная собственность месье Лападита?
+++ its a pleasure to meet you - приятно познакомиться с тобой
Certainly. After you. - Определенно. После вас.
+++ My brain is at your service, ma'am. - Мой мозг к вашим услугам, мэм
The rumors I have heard - Слухи, которые Я слышал
Have a seat - присаживайтесь
dairy farm - молочная ферма
+++ would be safe in assuming you have milk - рисну предположить у вас есть молоко
If it would not offend them - если это их не обидит
to step outside - выходить
need to have a few words - нужно поговорить
I regret to inform you - Я c сожалением информируют тебя
exhausted the - исчерпал запасы
so inadequately - не должным образом
serve to embrass me - способствовало лишь тому, чтобы опозорить меня
I've been led to belive - Я убежден в вере (Я верю в то)
and it just so happens - и так уж случилось
for the remainder of the conversation. - до конца нашего разговора
+++ So, by all means, keep me informed. - Так что, в любом случае, держите меня в курсе.
Are you aware of my existence - Ты знаешь о моём существовании?
I've been ordered to carry out in France - Мне приказано выполнять во Франции
put you in charge - Поставил тебя во главе
of rounding up - облавы
who are either - Которые либо 
I aware about that - Я осведомлён об этом.
But like any enterprise - Но как и на любом предприятии
slight dublication of efforts - небольшое повторение принимаемых мер
+++ nevertheless - тем не менее
Assist me with answers - Поможешь мне с ответами
have been accounted for - уже обнаружены
they have vanished - они скрылись
Which leads me to the concluthion - Что подводит меня к выводу
so misleading - вводят в заблуждение
leading role - ведущая роль
are often revealing - приводят к открытиям
exact members of the household - членов семьи
delicious - восхитительного, прелестного
precisely - именно, точно, строго
trepidation - трепет
+++ Haydrich apparently - Хайдрих очевидно
hates the moniker - ненавидит прозвище
bestowed on him - наградила его
hangman - палач
is baffling to me - меня это удивляет
It would appear he has done everything - Как представляется он сделал всё
The feature that makes me - Особенность, что деляет меня
as opposed to most German soldiers - в отличии от большинства германских солдат
cunning and the predatory instincts of a hawk - хитростью и хищными инстинктами ястреба
But where our conclusion differ - Где наши мнения расходятся
I do not consider the comparision an insult - Я не рассматривают это сравнение как оскорбление
Consider of a moment - Рассмотрим на секунду 
hostile world indeed - враждебный мир в самом деле
to scamper throught you front door - проскочила через парадный вход
would you greet it with hostility? - вы бы встретили её враждебно?
+++ I suppose I would - Я полагаю, что да
this animosity - эту вражду
spread disease - распространяют болезнь
They bite people - они кусают людей
+++ I propose to you - Я предлагаю тебе
squirrel - белка
A they both rodents - Они оба грызуны
saucer - тарелка, блюдце
Probably not - скорее всего
You find them repulsive - ты находишь их омерзительными
consequently - следовательно
conducts a search - проводит обыск
attic - чердак 
cellar - подвал
+++ It would never occur to phil that another man - would ever look twice at me. - Фил даже представить себе не может, что другой мужчина посмотрит на меня дважды.
So that is a tremendous lacuna in the report itself.  -  Это колоссальный пробел в отчете
human beings are capable - на что способен человек
once they abandon dignity. - стоит им забыть (отказаться) о достоинстве
any irregularities - любые нарушения
+++ But rest assured, I have the site under control.  -  Но будьте уверены, я держу это место под контролем.
make my duty easier - сделает мои служебные обязанности легче
+++ They did not build to forget - quite the contrary. - Они не строили чтобы забыть, - совсем наоборот
ceased to be harrased - прекращает преследоваться
sheltering the enemies - укрываешь врагов
Point out the areas where they - Укажи на зоны где они 
+++ I want you to follow my masquarade -  Я хочу чтобы ты мне подыграл
+++ Is that clear - Это ясно?
and your hospitality - и твоё гостеприимство 
putting together a special team - собрать вместе специальную команду
bushwhacking - расчищая заросли (???)
guerrilla army - партизанская армия
direct descendant - прямой потомок
Apache resistance - индейское сопротивление
We will be cruel to the Germans - Мы будем жестокими с германцами
disembowel, dismembered, disfigured  - выпотрошенные, расчленённые, изуродованные
sickened by us - будет тошнить от нас
tortured by their subconscious - мучаться от их подсознания
bat - бита
gossip - сплетня
They seem to be able to elude capture like an apparition. - Они выглядят как будто могут ускользать от захвата как призраки
pleased to meet you - приятно с вами познакомиться
needless to say - не приходиться говорить что
Either kill you or let you go - Либо убить тебя либо отпустить
depends entirely on you - зависит полностью от тебя
orchard - сад
divulge the information - разглашать информацию
I respectfully refuse, sir - Я с уважанием отказываюсь, сэр
oblige him - Сделай одолжение ему
I adore your cinema very much - Я обожаю ваш кинотеатр очень сильно
admire - восхищаться
+++ Regardless - независимо от того, 
+++ pestering me - приставать ко мне
A bird's nest - птичье гнездо
offspring of slaves - потомство рабов 
competitive athletically - конкурентноспособной атлетично
+++ Your reputation precedes you - Твоя репутация опережает тебя
+++ duly noted - Должным образом подмечено
It appears - Кажется
persuasive monster - убедительного монстра
I'n inclined in indulge you in anything - Я сколнен потакать тебе во всём
to his next appointment - к его следующей встрече
joyous German occasion - радостного германского случая
That sounds suspiciously - Это выглядит подозрительно
Your authorithy is beyound question - Ваша авторитетность за пределами вопроса (вне сомнений)
be concerned - это коснётся?
He is simply smitten - Он просто влюблён
came to be acquainted - пришли к знакомству?
exploits - подвиги
+++ let me interrupt you - позвольте прервать вас
No reason for you to fell anxious - Нет причины для тебя чтобы чувствовать беспокойства
prowess of Negro - мастерство Негра
+++ Is it acceptable - это примемлимо?
spruce - ель
+++ In my presence - В моём присутствии

__________
CHAPTER 4


